R 123456   4433254


NO files/greystone.xpm
SO files/mossy.xpm
WE files/wood.xpm     
EA files/purplestone.xpm
S files/eagle.xpm
F 53,5,134
C 0,0,0

11111111111  111111111
1000000001111100000001
1000200000E00000000111
10000000000000000001
1000000000001100000111
100000000000000000001
100000000000000002011
100000000000000000001
111111111111111111111
11111111111
